X            X
A            A
XXXXXXX      X
X            X
X     XXXXXXXX
X            X
X         X
A            A
X            A
X            X
X            X