X            X
X            X
XXXXXXX      X
X            X
X     XXXXXXXX
X            X
X            X
X            X
X            X
X            X
X            X
